####################
#######      ##   ##
        ####    # ##
## #### ######### ##
##    # #       # ##
##### # # ##### # ##
# ### ### ## ## # ##
#  ## #   ## ## # ##
## ##   #### ## # ##
## ####      ## # ##
## ############ # ##
##              # ##
## ## ## ######## ##
#   # ##  ###     ##
# # # ### ##########
# # #   #           
### ################
#   ###        ## ##
###     ######    ##
####################